This is a log of what happened to various accounts on D-day.

Archived account for say, hippy_girl would be hippy_girl.tar.gz

The archived files are all in /home/archive

See also /home/removed for previous archives done by someone other than
me 8-)

There are still lots of accounts in /home about which I have no
documentation, and I don't think I should delete these without further
consultation.

Sorry to anyone who got deleted inappropriately. We do think you were
warned.

-------------------------------------------------------------------------

Notes: 


a-list: Archived : deleted.
activista: not on database. No contents. Deleted.
adam: part of active sydney; overdue seven months. no contents. not
      archived. Deleted.
andy: part of active sydney: overdue seven months. has been known to
      donate machines, expertise). Not archived... but
      oooh, we were tempted. Maybe we will. Grr. Lucky boy.
anet: had two empty mail folders. Not archived. deleted.
alfalfa: overdue 25 months. archived. deleted.
alifeast: alistair f east. overdue 29 months. Directory empty. deleted.
alister air / talisman : overdue 17 months. archived (4Megs!) Deleted.
andrew trimboli : overdue 28 months. archived. deleted.
angry people : apeople : overdue 44 months. archived. deleted.
anna kortzchak : bimbo: overdue 31 months. archived. deleted.
bikeast: overdue 16 months. archived (18megs!). deleted.
camerons : part of active sydney. overdue 7 months. archived. deleted.
catman : john curtis : overdue 44 months. archived. deleted.
charlesw : part of active sydney. overdue 7 months. archived. deleted.
chris: chris arnison : overdue 27 months. archived. deleted.
chuckl : 27 months overdue. archived. deleted.
cjm : chris mountford : no account record. archived. deleted.
brenten : overdue 47 months. archived. deleted. 
davidb : no account in m'ship database. last axs 1998. archived. deleted.
davidos : david oslington : permitted delete. deleted.
egw: Wild Earth. empty account. overdue 33 months. deleted.
gavin : gavin unsworth : overdue 36 months. archived. deleted.
geekgirl : rosie x  : no account, no payment record. deleted.  
greta : greta werner / serene chaos : changed ISP. empty. deleted.
hamilton : scott hamilton. overdue 29 months. archived. deleted.
jinx : overdue 12 months. archived. deleted.
jocelyn : jocelyn hungerford : overdue 35 months. archived. deleted. 
jonathan : part of active sydney. overdue 7 months. archived. deleted.
johno : john aitken : overdue 41 months. archived. deleted.
karina : karina brisby : overdue 30 months. archived. deleted.
kathy : kathy grattan : 29 months overdue. Permitted delete. deleted. 
kat : philarney unwin : overdue 39 months. archived. deleted.
kim : overdue 25 months : archived. deleted.
kl : puzzle media: overdue 34. archived. deleted.
lukemute : luke bennet : overdue 32 months. archived. deleted.
mammoth : johnathon downes : overdue 38 months. archived. deleted.
merro : meredith williams : overdue 35 months. no account in /home.
mdagn : michael dagn : overdue 34 months. archived. deleted.
michaelg : Permitted delete. deleted.
misha : overdue 24 months. archived. deleted.
monique : monique potts : overdue 25 months. archived. deleted.
mrbeardy : james butcher : overdue 35 months. archived. deleted.
nbp : account accidentally created. Now deleted.
neil : neil short : overdue 36 months. no account in /home. deleted.
nicks : nicholas salzberg : overdue 4 months. archived. deleted. 
npc : newtown political collective. Wins the record time of overdue fees
      with a biiiig FIFTY-FOUR MONTHS! No account in /home. deleted.
paulb. Paul Black (triode) : contra, a/c empty, last axs 1996. deleted.
rosiex : rosie cross : no membership record. Old mail archived. deleted.
riki : no membership record. archived. deleted.
robj : overdue 25 months. archived. deleted.
stuartg : stuart gilmore: overdue 49 months. archived. deleted.
reinoud : no account. deleted.
vibe : hardly : overdue 36 months. archived. deleted. 
will : will kemp :overdue 34 months. deleted.

--------------------------------------------------------------------------

Thanks to Hugh and JJ for their assistance.


<predator>
